
ชุดข้อมูล Chern Telecom เกี่ยวกับการสื่อสารและบริการโทรคมนาคมประกอบด้วยคอลัมน์ต่อไปนี้:

State: รัฐหรือจังหวัดที่ลูกค้าอยู่ในปัจจุบัน
Account length: จำนวนวันที่ลูกค้าเป็นสมาชิกหรือใช้บริการ
Area code: รหัสพื้นที่ทางโทรศัพท์
International plan: บอกว่าลูกค้ามีแผนการใช้บริการโทรศัพท์ระหว่างประเทศหรือไม่ (Yes/No)
Voice mail plan: บอกว่าลูกค้ามีแผนการใช้งานระบบเสียงระบายเสียงหรือไม่ (Yes/No)
Number vmail messages: จำนวนข้อความระบบเสียงระบายเสียงที่ลูกค้าได้รับ
Total day minutes: จำนวนนาทีที่ใช้ในการโทรในช่วงกลางวัน
Total day calls: จำนวนการโทรในช่วงกลางวัน
Total day charge: ค่าบริการในการโทรในช่วงกลางวัน
Total eve minutes: จำนวนนาทีที่ใช้ในการโทรในช่วงเย็น
Total eve calls: จำนวนการโทรในช่วงเย็น
Total eve charge: ค่าบริการในการโทรในช่วงเย็น
Total night minutes: จำนวนนาทีที่ใช้ในการโทรในช่วงกลางคืน
Total night calls: จำนวนการโทรในช่วงกลางคืน
Total night charge: ค่าบริการในการโทรในช่วงกลางคืน
Total intl minutes: จำนวนนาทีที่ใช้ในการโทรระหว่างประเทศ
Total intl calls: จำนวนการโทรระหว่างประเทศ
Total intl charge: ค่าบริการในการโทรระหว่างประเทศ
Customer service calls: จำนวนการติดต่อบริการลูกค้า
Churn: บอกว่าลูกค้าได้ยกเลิกการใช้บริการหรือไม่ (Yes/No)


ชุดข้อมูลรถยนต์ (Car Dataset) ประกอบด้วยคอลัมน์ต่อไปนี้:

Make: ผู้ผลิตรถยนต์
Model: รุ่นรถยนต์
Year: ปีที่ผลิตรถยนต์
Engine Fuel Type: ประเภทเชื้อเพลิงของเครื่องยนต์
Engine HP: กำลังม้าของเครื่องยนต์
Engine Cylinders: จำนวนสูบของเครื่องยนต์
Transmission Type: ประเภทของระบบเกียร์
Driven_Wheels: ล้อขับของรถยนต์
Number of Doors: จำนวนประตูของรถยนต์
Market Category: ประเภทตลาดของรถยนต์
Vehicle Size: ขนาดของรถยนต์
Vehicle Style: ลักษณะรูปลักษณ์ของรถยนต์
highway MPG: อัตราการใช้น้ำมันต่อไมล์ในทางหลวง
city MPG: อัตราการใช้น้ำมันต่อไมล์ในเมือง
Popularity: ความนิยมของรถยนต์
MSRP: ราคาขายปลีกแนะนำ (Manufacturer's Suggested Retail Price)






